"filename", "language", "Makefile", "C++", "Markdown", "HTML", "Shell Script", "comment", "blank", "total"
"d:\information\IOT\learn\C++\opensource\WebFileServer\README.md", "Markdown", 0, 0, 46, 0, 0, 0, 26, 72
"d:\information\IOT\learn\C++\opensource\WebFileServer\build.sh", "Shell Script", 0, 0, 0, 0, 1, 1, 1, 3
"d:\information\IOT\learn\C++\opensource\WebFileServer\event\myevent.cpp", "C++", 0, 427, 0, 0, 0, 132, 112, 671
"d:\information\IOT\learn\C++\opensource\WebFileServer\event\myevent.h", "C++", 0, 72, 0, 0, 0, 26, 33, 131
"d:\information\IOT\learn\C++\opensource\WebFileServer\fileserver\fileserver.cpp", "C++", 0, 184, 0, 0, 0, 30, 30, 244
"d:\information\IOT\learn\C++\opensource\WebFileServer\fileserver\fileserver.h", "C++", 0, 30, 0, 0, 0, 8, 16, 54
"d:\information\IOT\learn\C++\opensource\WebFileServer\html\fileitem.html", "HTML", 0, 0, 0, 1, 0, 3, 0, 4
"d:\information\IOT\learn\C++\opensource\WebFileServer\html\filelist.html", "HTML", 0, 0, 0, 64, 0, 1, 6, 71
"d:\information\IOT\learn\C++\opensource\WebFileServer\main.cpp", "C++", 0, 31, 0, 0, 0, 5, 7, 43
"d:\information\IOT\learn\C++\opensource\WebFileServer\makefile", "Makefile", 5, 0, 0, 0, 0, 0, 2, 7
"d:\information\IOT\learn\C++\opensource\WebFileServer\message\message.h", "C++", 0, 99, 0, 0, 0, 25, 43, 167
"d:\information\IOT\learn\C++\opensource\WebFileServer\threadpool\threadpool.cpp", "C++", 0, 88, 0, 0, 0, 15, 17, 120
"d:\information\IOT\learn\C++\opensource\WebFileServer\threadpool\threadpool.h", "C++", 0, 25, 0, 0, 0, 9, 10, 44
"d:\information\IOT\learn\C++\opensource\WebFileServer\utils\utils.cpp", "C++", 0, 75, 0, 0, 0, 11, 17, 103
"d:\information\IOT\learn\C++\opensource\WebFileServer\utils\utils.h", "C++", 0, 15, 0, 0, 0, 8, 11, 34
"Total", "-", 5, 1046, 46, 65, 1, 274, 331, 1768